....................
....................
....................
....................
....................
....................
....................
....................
....................
....................
....................
....................
....................
.1..................
####################
